256,-23495,-60,-23555,-23207,0,-23207,252
256,256,0,256,253,0,253,253
256,255,1,256,253,0,253,253
512,512,0,512,504,0,504,504
512,510,2,512,506,0,506,506
768,767,1,768,758,0,758,758
768,768,0,768,760,0,760,760
1024,1024,0,1024,1011,0,1011,1011
1536,1532,4,1536,1514,0,1514,1514
1792,1783,9,1792,1764,0,1764,1764
2560,2552,9,2561,2521,0,2521,2521
3328,3310,18,3328,3270,0,3270,3270
4352,4348,4,4352,4288,0,4288,4288
5632,5619,14,5633,5554,0,5554,5554
7424,7415,10,7425,7325,0,7325,7325
9728,9722,8,9730,9601,0,9601,9601
12544,12531,14,12545,12380,0,12380,12380
16640,16622,19,16641,16418,0,16418,16418
22016,21975,44,22019,21711,0,21711,21711
28928,28883,45,28928,28542,0,28542,28542
37888,37828,66,37894,37375,0,37375,37375
50944,50861,88,50949,50259,0,50259,50259
64000,63880,127,64007,63094,0,63094,63094
65024,64899,131,65030,64097,0,64097,64097
66304,66201,109,66310,65384,0,65384,65384
67328,67226,108,67334,66414,0,66414,66414
68608,68473,142,68615,67650,0,67650,67650
69888,69727,170,69897,68869,0,68869,68869
70912,70756,158,70914,69893,0,69893,69893
71680,71565,124,71689,70677,0,70677,70677
73728,73611,122,73733,72690,0,72690,72690
75008,74875,141,75016,73959,0,73959,73959
75520,75439,90,75529,74515,0,74515,74515
77568,77402,177,77579,76456,0,76456,76456
79104,78940,168,79108,77979,0,77979,77979
80128,79984,154,80138,78984,0,78984,78984
81664,81519,151,81670,80518,0,80518,80518
82944,82826,129,82955,81809,0,81809,81809
84736,84592,152,84744,83561,0,83561,83561
85760,85609,155,85764,84546,0,84546,84546
87808,87619,198,87817,86544,0,86544,86544
88832,88679,159,88838,87602,0,87602,87602
90880,90735,151,90886,89638,0,89638,89638
91904,91783,128,91911,90649,0,90649,90649
93696,93570,132,93702,92435,0,92435,92435
95744,95556,200,95756,94392,0,94392,94392
97536,97377,166,97543,96189,0,96189,96189
99072,98889,189,99078,97652,0,97652,97652
100864,100686,187,100873,99447,0,99447,99447
102656,102479,186,102665,101196,0,101196,101196
102912,102757,164,102921,101479,0,101479,101479
104448,104252,206,104458,102946,0,102946,102946
108288,108114,184,108298,106766,0,106766,106766
110336,110135,213,110348,108750,0,108750,108750
112128,111955,189,112144,110586,0,110586,110586
114176,113964,221,114185,112579,0,112579,112579
116224,116050,184,116234,114603,0,114603,114603
118016,117856,170,118026,116386,0,116386,116386
119040,118864,182,119046,117413,0,117413,117413
121088,120889,209,121098,119380,0,119380,119380
124416,124150,281,124431,122604,0,122604,122604
126720,126528,205,126733,124989,0,124989,124989
128768,128523,253,128776,126966,0,126966,126966
130560,130371,206,130577,128775,0,128775,128775
133376,133131,262,133393,131463,0,131463,131463
135680,135424,266,135690,133787,0,133787,133787
138240,137996,266,138262,136261,0,136261,136261
140800,140533,279,140812,138777,0,138777,138777
143104,142869,251,143120,141090,0,141090,141090
145664,145409,281,145690,143641,0,143641,143641
148224,147953,282,148235,146142,0,146142,146142
150784,150503,295,150798,148675,0,148675,148675
153600,153345,266,153611,151483,0,151483,151483
155904,155659,265,155924,153728,0,153728,153728
158720,158423,314,158737,156474,0,156474,156474
161536,161295,258,161553,159329,0,159329,159329
164608,164308,319,164627,162308,0,162308,162308
167168,166875,315,167190,164797,0,164797,164797
169472,169142,349,169491,167095,0,167095,167095
173056,172769,310,173079,170624,0,170624,170624
176128,175805,336,176141,173619,0,173619,173619
179200,178862,357,179219,176627,0,176627,176627
182272,181974,322,182296,179731,0,179731,179731
185344,185053,309,185362,182795,0,182795,182795
188672,188400,290,188690,186115,0,186115,186115
192000,191698,316,192014,189300,0,189300,189300
195584,195200,410,195610,192795,0,192795,192795
198912,198558,371,198929,196130,0,196130,196130
202496,202154,357,202511,199692,0,199692,199692
205824,205496,354,205850,202995,0,202995,202995
209408,209009,422,209431,206448,0,206448,206448
213248,212869,411,213280,210253,0,210253,210253
216832,216468,386,216854,213809,0,213809,213809
220416,220019,425,220444,217344,0,217344,217344
224256,223876,410,224286,221113,0,221113,221113
228096,227706,399,228105,224915,0,224915,224915
232192,231779,441,232220,228913,0,228913,228913
236032,235666,382,236048,232763,0,232763,232763
240384,239887,526,240413,236893,0,236893,236893
244736,244312,444,244756,241284,0,241284,241284
248576,248136,472,248608,245098,0,245098,245098
252928,252510,446,252956,249426,0,249426,249426
257280,256823,484,257307,253655,224,253879,253426
261632,261144,518,261662,257917,157,258074,257757
266752,266317,460,266777,263000,0,263000,263000
271104,270641,482,271123,267283,0,267283,267283
275456,275015,479,275494,271639,0,271639,271639
280064,279572,518,280090,276122,0,276122,276122
285184,284726,488,285214,281224,0,281224,281224
290304,289797,533,290330,286224,0,286224,286224
295168,294748,448,295196,291145,0,291145,291145
300544,300032,542,300574,296342,0,296342,296342
305920,305421,523,305944,301637,0,301637,301637
311040,310511,560,311071,306686,0,306686,306686
315904,315384,553,315937,311510,0,311510,311510
321536,320995,578,321573,317047,0,317047,317047
327424,326774,677,327451,322758,0,322758,322758
332544,331917,661,332578,327737,0,327737,327737
338176,337594,614,338208,333434,0,333434,333434
343808,343173,664,343837,338940,0,338940,338940
349696,349094,637,349731,344747,0,344747,344747
355584,354953,668,355621,350570,0,350570,350570
361728,360797,703,361500,356348,356,356704,355983
368128,367494,673,368167,362953,0,362953,362953
374784,374148,687,374835,369531,0,369531,369531
382976,382328,698,383026,377646,0,377646,377646
387584,386924,706,387630,382099,0,382099,382099
393984,393265,757,394022,388423,0,388423,388423
400384,399712,704,400416,394746,0,394746,394746
408064,407367,732,408099,402375,85,402460,402287
414208,413534,710,414244,408397,234,408631,408158
421632,420893,783,421676,415743,173,415916,415566
428800,428111,731,428842,422883,0,422883,422883
435968,435232,775,436007,429819,233,430052,429581
443648,442836,860,443696,437400,0,437400,437400
450304,449460,891,450351,443971,1,443972,443969
458240,457331,957,458288,451657,0,451657,451657
464896,464090,854,464944,458405,0,458405,458405
472832,471986,893,472879,466126,0,466126,466126
481280,480361,966,481327,474518,0,474518,474518
489216,488366,905,489271,482390,0,482390,482390
497664,496791,926,497717,490721,0,490721,490721
506368,505574,850,506424,499323,0,499323,499323
515584,514713,927,515640,508428,173,508601,508251
523264,522368,947,523315,515936,230,516166,515700
532992,532085,970,533055,525448,0,525448,525448
540928,539790,1193,540983,533046,750,533796,532283
550144,549128,1075,550203,542370,368,542738,541993
559616,558635,1043,559678,551709,391,552100,551307
568832,567891,998,568889,560940,318,561258,560614
577536,576518,1079,577597,569351,0,569351,569328
587520,586567,1011,587578,579304,250,579554,579048
596224,595116,1186,596302,587774,152,587926,587618
607744,606710,1085,607795,599263,0,599263,599263
616960,615830,1185,617015,608274,0,608274,608274
625664,624405,1316,625721,616740,193,616933,616541
639488,638335,1218,639553,630444,426,630870,630005
648192,647048,1214,648262,639141,312,639453,638767
659712,658577,1200,659777,650413,706,651119,649690
670208,669060,1202,670262,660762,159,660921,660599
679424,678129,1365,679494,669846,139,669985,669703
692224,690921,1362,692283,682416,403,682819,682002
702208,700901,1386,702287,692208,672,692880,691518
713984,712698,1353,714051,703975,283,704258,703684
725760,724443,1402,725845,715562,699,716261,714845
738048,736691,1442,738133,727548,900,728448,726626
750848,749471,1462,750933,740239,1152,741391,739059
764416,763161,1337,764498,753710,906,754616,752780
773888,772546,1414,773960,763007,595,763602,762396
787456,785100,2433,787533,775275,4102,779377,771092
799744,798419,1413,799832,788549,513,789062,788021
813056,811255,1885,813140,801211,2242,803453,798921
824320,822832,1561,824393,812611,621,813232,811976
839936,838596,1425,840021,828260,1233,829493,826994
852224,850631,1690,852321,840144,906,841050,839214
867328,865727,1695,867422,855004,810,855814,854173
879104,877591,1589,879180,866761,1534,868295,865189
895488,893857,1710,895567,882880,479,883359,882387
908032,906014,2106,908120,894765,2707,897472,892001
922624,921003,1712,922715,909577,1352,910929,908195
935936,934410,1627,936037,922831,1909,924740,920875
951808,949999,1917,951916,938383,2397,940780,935929
965632,963921,1822,965743,952049,1774,953823,950229
981248,979524,1819,981343,967408,1686,969094,965682
996352,994511,1945,996456,982247,1507,983754,980703
1020416,1018466,2068,1020534,1005937,2112,1008049,1003775
1029632,1027780,1947,1029727,1015149,2031,1017180,1013070
1041664,1039717,2050,1041767,1026947,1876,1028823,1025028
1060608,1058610,2106,1060716,1045461,2029,1047490,1043330
1075968,1073927,2157,1076084,1060600,1190,1061790,1059383
1092096,1090075,2121,1092196,1076637,1878,1078515,1074711
1107456,1105332,2255,1107587,1091697,1981,1093678,1089666
1127936,1125333,2723,1128056,1111313,4101,1115414,1107124
1144064,1141750,2432,1144182,1127738,2792,1130530,1124882
1162752,1160495,2383,1162878,1146211,2867,1149078,1143273
1183744,1181499,2375,1183874,1166909,1216,1168125,1165610
1195008,1192792,2320,1195112,1178107,2775,1180882,1175264
1217024,1214735,2402,1217137,1199719,3389,1203108,1196248
1233152,1230651,2638,1233289,1215461,3780,1219241,1211590
1256704,1254385,2452,1256837,1238947,2689,1241636,1236188
1276672,1274220,2574,1276794,1258594,4025,1262619,1254461
1287680,1284680,3131,1287811,1268773,5257,1274030,1263400
1308928,1305840,3232,1309072,1289737,5448,1295185,1284163
1331456,1328909,2695,1331604,1312445,3554,1315999,1308793
1344512,1342004,2650,1344654,1325434,5510,1330944,1319774
1370880,1368102,2936,1371038,1351315,3545,1354860,1347683
1389312,1386846,2614,1389460,1369778,6638,1376416,1362965
1413120,1410345,2936,1413281,1392818,3720,1396538,1388999
1425152,1422442,2842,1425284,1404715,5090,1409805,1399507
1451008,1448513,2641,1451154,1430738,4292,1435030,1426331
1472256,1468322,4097,1472419,1450190,10899,1461089,1439032
1496064,1493221,3001,1496222,1474776,10279,1485055,1464236
1518336,1515557,2929,1518486,1496874,6285,1503159,1490416
1540352,1537564,2934,1540498,1518673,8184,1526857,1510274
1566464,1563470,3162,1566632,1544129,16142,1560271,1527579
1588224,1585253,3126,1588379,1565661,7544,1573205,1557864
1611520,1608489,3203,1611692,1588425,7167,1595592,1581012
1644544,1641770,2967,1644737,1621526,20498,1642024,1600453
1662976,1659771,3380,1663151,1639309,9530,1648839,1629523
1687040,1683711,3490,1687201,1662938,6251,1669189,1654809
1700864,1697812,3223,1701035,1676726,26234,1702960,1649757
1728000,1723953,4217,1728170,1702542,24011,1726553,1652173
1791488,1787881,3803,1791684,1765764,34747,1800511,1652942
1782528,1779137,3563,1782700,1757138,17638,1774776,1726296
1807104,1802886,4155,1807041,1780726,46485,1827211,1701745
1805056,1801083,4168,1805251,1778754,30383,1809137,1720622
1836288,1833071,3409,1836480,1810553,128750,1939303,1676694
1870592,1867228,3561,1870789,1844266,205593,2049859,1631567
1916928,1913311,3800,1917111,1889823,279871,2169694,1591929
1930240,1926099,4346,1930445,1902314,211943,2114257,1603256
1955584,1951603,4196,1955799,1927474,187111,2114585,1672411
1985024,1980424,4796,1985220,1955931,253185,2209116,1673834
2005248,2000862,4587,2005449,1976160,277036,2253196,1672564
2055168,2051252,4155,2055407,2026041,311615,2337656,1680154
2060544,2056329,4433,2060762,2030910,517541,2548451,1490444
2090496,2086839,3906,2090745,2061003,594702,2655705,1449260
2114048,2110279,3991,2114270,2084393,675186,2759579,1383429
2144000,2140160,4081,2144241,2113750,692572,2806322,1397423
2176256,2171332,5161,2176493,2144396,493976,2638372,1585369
2209024,2203363,5894,2209257,2175942,522374,2698316,1597882
2230016,2224833,5431,2230264,2197319,703211,2900530,1474576
2254080,2248830,5480,2254310,2221059,588967,2810026,1588299
2301696,2295702,6238,2301940,2267140,648079,2915219,1583963
2322176,2316743,5652,2322395,2287975,652737,2940712,1578557
2343680,2337930,5974,2343904,2308871,684236,2993107,1577526
2378752,2372935,6085,2379020,2343542,1006922,3350464,1301748
2400256,2394434,6061,2400495,2364651,846837,3211488,1491947
2432256,2426223,6281,2432504,2396008,806126,3202134,1563472
2463232,2457031,6478,2463509,2426356,968086,3394442,1432993
2495488,2489404,6350,2495754,2458416,903735,3362151,1530377
2525952,2520124,6091,2526215,2488868,925281,3414149,1538832
2556672,2550221,6714,2556935,2518692,1196150,3714842,1290533
2577408,2571618,6046,2577664,2539829,979622,3519451,1533853
2629888,2623298,6830,2630128,2590807,1254332,3845139,1285911
2645760,2639104,6930,2646034,2606398,1252989,3859387,1301442
2688000,2681942,6352,2688294,2648691,1146826,3795517,1465779
2722560,2715189,7647,2722836,2681561,1214375,3895936,1437038
2731520,2724293,7497,2731790,2690453,1230053,3920506,1429491
2778624,2771503,7405,2778908,2737134,1267835,4004969,1437868
2815744,2807541,8497,2816038,2772523,1443837,4216360,1293825
2842624,2834609,7787,2842396,2799470,1554310,4353780,1208382
2868736,2863269,5788,2869057,2828052,1966003,4794055,817849
2901504,2896570,5234,2901804,2860888,2014128,4875016,801386
2981888,2974738,7481,2982219,2937974,1858502,4796476,1036911
2975232,2969054,6498,2975552,2932265,1846111,4778376,1043653
2979584,2970007,9876,2979883,2932939,1513150,4446089,1383542
3062528,3054951,7890,3062841,3016882,1682536,4699418,1294097
3057920,3048828,9426,3058254,3010827,1639519,4650346,1332215
3088384,3081128,7606,3088734,3042729,1697911,4740640,1304531
3119104,3106422,13042,3119464,3067046,1737360,4804406,1288989
3197184,3187020,10519,3197539,3147202,1870088,5017290,1233534
3232256,3222836,9773,3232609,3182662,1909690,5092352,1228972
3252992,3243830,9527,3253357,3203592,2350297,5553889,800574
3280128,3272655,7814,3280469,3232069,2612522,5844591,561890
3334400,3327359,7394,3334753,3286124,2286351,5572475,948328
3370496,3360393,10460,3370853,3318490,2661245,5979735,598471
3391232,3384852,6719,3391571,3343311,2799875,6143186,481852
3426304,3420413,6274,3426687,3378339,2855714,6234053,459894
3453952,3446848,7500,3454348,3404311,2901378,6305689,439396
3507200,3500955,6634,3507589,3457698,2809882,6267580,585729
3527168,3514690,12877,3527567,3470583,2472587,5943170,942941
3607552,3593859,14097,3607956,3548618,2537886,6086504,955290
3602432,3592428,10376,3602804,3547452,2506754,6054206,986472
3645184,3632266,13283,3645549,3586693,2614996,6201689,913801
3709184,3699290,10252,3709542,3653217,2954489,6607706,634451
3729664,3713686,16351,3730037,3666684,2656301,6322985,952578
3765504,3756599,9273,3765872,3710105,3337683,7047788,299403
3794176,3786795,7774,3794569,3739852,3256211,6996063,412740
3810048,3799414,11034,3810448,3752144,3266029,7018173,415002
3841280,3833786,7901,3841687,3786472,3483392,7269864,227037
3904000,3887110,17333,3904443,3837638,2884072,6721710,890937
3966464,3956161,10741,3966902,3907034,3638844,7545878,188986
3944448,3937176,7698,3944874,3888570,3633988,7522558,175440
4009728,4002253,7885,4010138,3952898,3750733,7703631,120656
4032768,4016594,16621,4033215,3965972,3426877,7392849,464842
4110336,4086083,24729,4110812,4033073,3177785,7210858,786667
4121344,4109517,12302,4121819,4058108,3788424,7846532,187307
4162048,4153416,9025,4162441,4101994,3956991,8058985,59018
4210688,4198847,12290,4211137,4146595,4011470,8158065,48201
4211712,4199807,12329,4212136,4147464,3979546,8127010,81540
4252672,4243537,9623,4253160,4190962,4056760,8247722,46028
4384256,4371997,12673,4384670,4317692,4179813,8497505,47098
4344320,4335607,9205,4344812,4281974,4146661,8428635,45226
4441088,4432205,9364,4441569,4377492,4240650,8618142,44773
4403200,4393632,10020,4403652,4339342,4203977,8543319,44084
4454144,4438188,16384,4454572,4382479,4242539,8625018,48018
4481280,4467233,14542,4481775,4411402,4273280,8684682,45331
4477696,4466776,11371,4478147,4411478,4267704,8679182,51200
4518656,4493139,25789,4518928,4435087,3757732,8192819,595619
4603904,4587965,16447,4604412,4530113,4310742,8840855,125863
4621312,4596107,25766,4621873,4536850,3905284,8442134,547334
4633856,4613552,20834,4634386,4555041,4274084,8829125,188294
4707584,4683266,24892,4708158,4623223,4184913,8808136,347974
4717312,4703369,14404,4717773,4644576,4501213,9145789,45666
4737024,4727297,10223,4737520,4668730,4528876,9197606,41635
4782336,4771630,11187,4782817,4712365,4570452,9282817,42531
4864512,4851514,13319,4864833,4791038,4629079,9420117,61903
4858624,4824210,34971,4859181,4761353,4366989,9128342,300046
4909824,4897900,12461,4910361,4837127,4693734,9530861,41481
4928512,4913194,15805,4928999,4851977,4703850,9555827,46142
4992512,4981062,11965,4993027,4919218,4774997,9694215,40558
5002240,4987446,15292,5002738,4925093,4776338,9701431,45088
5006848,4990946,16165,5007111,4928369,4698541,9626910,128182
5358848,5307536,52322,5359858,5235491,4970588,10206079,157671
5669120,5653158,16582,5669740,5582508,5426004,11008512,38724
6019072,5992850,26895,6019745,5917187,5748308,11665495,44030
6287872,6267325,21256,6288581,6188295,6015780,12204075,41928
6551040,6521514,30299,6551813,6438429,6263251,12701680,39481
6849536,6812494,37854,6850348,6724388,6544263,13268651,38358
7062272,7022387,40761,7063148,6931942,6749086,13681028,36816
7365376,7036183,325204,7361387,6899357,6569399,13468756,195174
7615488,7556833,59556,7616389,7457196,7266408,14723604,34806
7726592,7654169,73346,7727515,7551834,7358138,14909972,36019
7913216,7831075,82800,7913875,7725312,7528153,15253465,36127
8011008,7677803,327435,8005238,7532182,7230632,14762814,153792
8007680,7513140,492346,8005486,7343560,6972036,14315596,234034
7786752,7547230,222762,7769992,7422080,7158267,14580347,114422
8071424,7968103,99619,8067722,7859937,7658547,15518484,38571
8379392,8261708,114887,8376595,8147056,7940509,16087565,39383
8267008,7806789,452647,8259436,7641326,7305828,14947154,191375
8115200,7593418,503939,8097357,7418304,7043971,14462275,236640
256,-575649182,-4635386,-580284568,-567999387,-362768582,-930767969,253
256,256,0,256,252,0,252,252
256,256,0,256,254,0,254,254
512,510,3,513,503,0,503,503
512,511,1,512,505,0,505,505
768,765,4,769,754,0,754,754
768,768,0,768,757,0,757,757
1024,1016,8,1024,1003,0,1003,1003
1536,1535,1,1536,1516,0,1516,1516
1792,1792,0,1792,1770,0,1770,1770
2560,2557,3,2560,2531,0,2531,2531
3328,3316,12,3328,3280,0,3280,3280
4352,4346,7,4353,4291,0,4291,4291
5632,5614,18,5632,5551,0,5551,5551
7424,7410,14,7424,7316,0,7316,7316
9728,9700,28,9728,9577,0,9577,9577
12544,12521,25,12546,12369,0,12369,12369
16640,16611,30,16641,16406,0,16406,16406
22016,21969,49,22018,21686,0,21686,21686
28928,28878,52,28930,28515,0,28515,28515
37888,37854,35,37889,37389,0,37389,37389
50176,50106,75,50181,49492,0,49492,49492
63232,63134,100,63234,62360,0,62360,62360
65024,64942,90,65032,64150,0,64150,64150
66048,65918,140,66058,65102,0,65102,65102
67328,67219,114,67333,66394,0,66394,66394
68352,68219,137,68356,67356,0,67356,67356
69632,69503,133,69636,68661,0,68661,68661
70912,70762,169,70931,69884,0,69884,69884
72192,72054,142,72196,71188,0,71188,71188
72704,72559,147,72706,71680,0,71680,71680
75008,74878,137,75015,73939,0,73939,73939
76032,75877,165,76042,74937,0,74937,74937
77568,77435,141,77576,76492,0,76492,76492
78848,78670,187,78857,77704,0,77704,77704
80384,80214,178,80392,79232,0,79232,79232
81920,81809,115,81924,80796,0,80796,80796
83200,83048,159,83207,82058,0,82058,82058
84224,84065,174,84239,83035,0,83035,83035
86016,85855,170,86025,84808,0,84808,84808
87808,87679,134,87813,86627,0,86627,86627
89344,89176,179,89355,88103,0,88103,88103
90880,90729,160,90889,89616,0,89616,89616
92416,92272,149,92421,91129,0,91129,91129
94208,94017,203,94220,92853,0,92853,92853
95744,95589,163,95752,94418,0,94418,94418
97024,96875,160,97035,95679,0,95679,95679
99328,99140,196,99336,97903,0,97903,97903
100864,100616,263,100879,99407,0,99407,99407
102144,101945,211,102156,100685,0,100685,100685
104448,104237,223,104460,102932,0,102932,102932
105984,105779,216,105995,104469,0,104469,104469
105472,105269,214,105483,103999,0,103999,103999
110080,109912,174,110086,108544,0,108544,108544
112128,111929,213,112142,110575,0,110575,110575
114176,113963,220,114183,112555,0,112555,112555
115968,115763,215,115978,114335,0,114335,114335
117760,117548,223,117771,116098,0,116098,116098
120320,120124,209,120333,118635,0,118635,118635
122368,122155,229,122384,120695,0,120695,120695
124416,124169,258,124427,122686,0,122686,122686
126720,126500,236,126736,124967,0,124967,124967
128000,127728,282,128010,126134,0,126134,126134
131072,130840,248,131088,129223,0,129223,129223
131840,131577,272,131849,129986,0,129986,129986
135168,134891,290,135181,133242,0,133242,133242
137728,137510,227,137737,135809,0,135809,135809
140544,140277,276,140553,138550,0,138550,138550
143104,142856,265,143121,141090,0,141090,141090
145664,145419,258,145677,143635,0,143635,143635
147712,147447,273,147720,145636,0,145636,145636
150784,150468,335,150803,148604,0,148604,148604
153344,153046,320,153366,151177,0,151177,151177
155392,155118,294,155412,153189,0,153189,153189
158720,158437,305,158742,156507,0,156507,156507
161536,161277,276,161553,159296,0,159296,159296
163840,163549,307,163856,161524,0,161524,161524
167168,166856,330,167186,164812,0,164812,164812
170752,170460,308,170768,168336,0,168336,168336
173056,172713,361,173074,170560,0,170560,170560
176128,175768,381,176149,173630,0,173630,173630
178688,178340,369,178709,176174,0,176174,176174
182528,182178,379,182557,179891,0,179891,179891
185600,185276,340,185616,182966,0,182966,182966
188416,188065,368,188433,185768,0,185768,185768
192000,191657,364,192021,189276,0,189276,189276
195584,195238,366,195604,192820,0,192820,192820
198912,198583,357,198940,196145,0,196145,196145
202496,202199,314,202513,199674,0,199674,199674
205824,205476,369,205845,202969,0,202969,202969
209408,209003,426,209429,206484,0,206484,206484
213504,213075,451,213526,210447,0,210447,210447
216320,215939,405,216344,213303,0,213303,213303
220672,220229,468,220697,217539,0,217539,217539
224000,223590,439,224029,220828,0,220828,220828
228096,227701,412,228113,224936,0,224936,224936
231936,231477,485,231962,228647,0,228647,228647
236288,235897,419,236316,232971,0,232971,232971
240128,239731,415,240146,236791,0,236791,236791
244224,243747,502,244249,240712,0,240712,240712
248576,248139,463,248602,245026,0,245026,245026
252928,252502,452,252954,249361,0,249361,249361
257792,257413,400,257813,254252,183,254435,254065
261888,261379,547,261926,258217,0,258217,258217
266752,266310,468,266778,263069,0,263069,263069
271104,270572,557,271129,267243,0,267243,267243
275456,275024,451,275475,271665,233,271898,271427
280576,280053,554,280607,276610,0,276610,276610
285184,284639,574,285213,281145,0,281145,281145
290304,289789,536,290325,286237,0,286237,286237
295424,294908,545,295453,291201,0,291201,291201
300544,300015,554,300569,296290,0,296290,296290
305408,304772,676,305448,301067,0,301067,301067
310784,310205,616,310821,306372,0,306372,306372
315648,315065,618,315683,311191,0,311191,311191
321024,320474,579,321053,316559,0,316559,316559
327168,326612,589,327201,322581,216,322797,322361
332544,331943,631,332574,327895,0,327895,327895
337920,337376,576,337952,333306,0,333306,333306
344320,343757,593,344350,339576,0,339576,339576
349696,349032,709,349741,344714,0,344714,344714
355840,355238,649,355887,350854,0,350854,350854
360960,360266,733,360999,355802,0,355802,355802
368128,367422,764,368186,362866,211,363077,362650
374016,373316,734,374050,368755,114,368869,368638
381952,381245,738,381983,376509,0,376509,376509
386816,386129,736,386865,381283,0,381283,381283
393984,393295,725,394020,388497,0,388497,388497
400128,399383,777,400160,394490,0,394490,394490
407296,406603,746,407349,401606,0,401606,401606
415232,414479,797,415276,409391,0,409391,409391
421120,420391,766,421157,415227,0,415227,415227
428544,427786,804,428590,422477,228,422705,422245
435456,434685,811,435496,429293,211,429504,429078
442880,442136,787,442923,436705,160,436865,436541
449536,448681,907,449588,443173,220,443393,442949
458752,457880,916,458796,452341,0,452341,452341
464896,463997,948,464945,458333,234,458567,458094
474624,473710,972,474682,467856,213,468069,467638
481024,480187,880,481067,474272,448,474720,473815
488192,487382,846,488228,481412,0,481412,481412
498176,497263,968,498231,491144,38,491182,491104
507904,506972,996,507968,500707,0,500707,500707
514560,513797,814,514611,507381,0,507381,507381
522752,521851,953,522804,515472,57,515529,515412
531712,530742,1024,531766,524229,286,524515,523935
540416,539416,1067,540483,532846,0,532846,532846
550912,549707,1251,550958,542912,1002,543914,541888
559360,558414,998,559412,551630,177,551807,551448
569088,568006,1145,569151,560954,272,561226,560675
577792,576798,1062,577860,569667,0,569667,569667
587264,586224,1089,587313,578989,64,579053,578923
597504,596454,1119,597573,589110,155,589265,588953
607488,606426,1121,607547,598938,98,599036,598839
615168,614088,1134,615222,606517,76,606593,606437
626432,625300,1198,626498,617576,573,618149,616988
639488,638411,1142,639553,630602,186,630788,630411
647680,646522,1219,647741,638574,868,639442,637684
657152,655924,1286,657210,647862,390,648252,647463
669952,668757,1267,670024,660501,228,660729,660267
679936,678739,1262,680001,670479,533,671012,669933
692224,690888,1418,692306,682310,831,683141,681460
703744,702541,1269,703810,693870,705,694575,693147
714752,713466,1349,714815,704749,562,705311,704174
725760,724390,1448,725838,715543,633,716176,714894
739840,738448,1465,739913,729383,400,729783,728973
750592,748995,1671,750666,739642,1956,741598,737648
764672,763021,1725,764746,753574,1410,754984,752132
774656,773114,1638,774752,763538,1528,765066,761978
786944,785566,1446,787012,775919,245,776164,775666
800256,798835,1505,800340,789067,1087,790154,787949
811264,809526,1826,811352,799501,1885,801386,797580
826112,824610,1592,826202,814440,425,814865,814001
838912,837475,1536,839011,827159,882,828041,826251
852480,850766,1800,852566,840348,726,841074,839603
866304,864489,1912,866401,853800,2699,856499,851040
878848,877199,1724,878923,866487,1155,867642,865305
894720,892756,2044,894800,881539,2647,884186,878833
905984,904085,2011,906096,892959,3161,896120,889729
921856,920186,1758,921944,908908,2065,910973,906788
933120,931406,1811,933217,919924,1662,921586,918226
950784,948852,2022,950874,937126,1706,938832,935377
966144,964323,1910,966233,952437,905,953342,951514
980224,977872,2454,980326,965783,3381,969164,962325
998400,996445,2075,998520,984142,1456,985598,982647
1011968,1010144,1954,1012098,997619,1776,999395,995799
1029120,1027171,2049,1029220,1014430,1948,1016378,1012432
1045504,1043670,1939,1045609,1030880,1842,1032722,1028994
1060864,1058719,2265,1060984,1045700,2379,1048079,1043270
1077248,1075171,2191,1077362,1062024,2364,1064388,1059602
1093888,1091594,2419,1094013,1078065,3693,1081758,1074282
1111808,1109721,2205,1111926,1096091,3536,1099627,1092473
1123328,1121105,2353,1123458,1107356,3237,1110593,1104047
1145856,1143926,2037,1145963,1129881,2792,1132673,1127021
1163776,1161374,2527,1163901,1147114,3620,1150734,1143355
1182464,1180205,2397,1182602,1165702,1528,1167230,1164136
1197824,1195504,2440,1197944,1180933,4545,1185478,1176223
1217536,1215309,2362,1217671,1200258,2912,1203170,1197274
1236224,1232505,3853,1236358,1217142,7059,1224201,1209936
1254400,1251397,3126,1254523,1235815,5549,1241364,1230147
1279744,1277265,2615,1279880,1261572,3193,1264765,1258301
1292032,1289552,2617,1292169,1273713,3381,1277094,1270249
1312000,1309458,2685,1312143,1293432,4406,1297838,1288898
1331456,1328065,3519,1331584,1311565,5137,1316702,1306323
1350656,1348049,2745,1350794,1331405,3035,1334440,1328284
1371904,1369380,2665,1372045,1352297,4849,1357146,1347323
1389568,1386614,3112,1389726,1369441,7873,1377314,1361368
1412864,1410093,2919,1413012,1392640,7549,1400189,1384892
1431040,1428286,2900,1431186,1410608,4672,1415280,1405820
1456640,1453358,3171,1456529,1435445,8668,1444113,1426506
1474304,1471093,3354,1474447,1452933,9083,1462016,1443617
1494784,1491884,3064,1494948,1473477,10463,1483940,1462690
1520384,1517364,3174,1520538,1498676,5830,1504506,1492682
1540096,1537170,3099,1540269,1518073,6733,1524806,1511147
1565184,1561899,3433,1565332,1542719,7473,1550192,1535048
1583616,1580426,3345,1583771,1560852,12680,1573532,1547749
1609216,1605906,3369,1609275,1586091,11379,1597470,1574276
1634304,1631271,3188,1634459,1611067,10465,1621532,1600256
1661952,1658590,3561,1662151,1638021,15554,1653575,1621167
1679104,1675786,3485,1679271,1655141,6757,1661898,1642128
1707264,1704099,3345,1707444,1683134,16916,1700050,1638289
1722624,1719102,3722,1722824,1697827,13913,1711740,1642628
1754624,1751008,3786,1754794,1729417,17260,1746677,1684729
1789440,1785737,3887,1789624,1763653,24060,1787713,1710744
1801472,1797654,4011,1801665,1775488,21342,1796830,1662967
1821184,1817337,4025,1821362,1794675,54912,1849587,1689968
1841408,1837572,4015,1841587,1814947,52336,1867283,1652351
1880832,1876805,4237,1881042,1853586,94338,1947924,1633953
1906176,1902051,4330,1906381,1878501,145190,2023691,1692225
1917696,1913762,4139,1917901,1890361,278140,2168501,1599427
1948416,1944792,3819,1948611,1920828,338393,2259221,1568105
1972992,1968453,4753,1973206,1944144,228774,2172918,1647487
2008832,2003570,5473,2009043,1978758,404718,2383476,1507181
2046720,2039901,7010,2046911,2014418,390729,2405147,1536341
2066176,2062364,4010,2066374,2037009,579942,2616951,1440407
2090496,2086754,3956,2090710,2061059,591568,2652627,1452474
2112256,2107578,4898,2112476,2081596,486921,2568517,1532848
2140160,2135140,5251,2140391,2108730,480310,2589040,1533133
2176256,2170776,5588,2176364,2143907,577317,2721224,1474446
2195456,2190874,4527,2195401,2163945,785328,2949273,1357928
2225408,2220810,4798,2225608,2193298,696488,2889786,1473145
2261248,2254975,6239,2261214,2227215,614054,2841269,1553662
2295808,2290189,5830,2296019,2261827,663586,2925413,1544919
2323456,2319173,4515,2323688,2290749,666741,2957490,1544609
2333952,2328051,6141,2334192,2299282,678469,2977751,1565798
2358272,2352796,5697,2358493,2323571,718865,3042436,1537225
2393344,2388143,5473,2393616,2358616,977056,3335672,1349339
2432256,2424949,7563,2432512,2394724,974395,3369119,1377862
2435072,2430541,4772,2435313,2400614,1225432,3626046,1145411
2495488,2489684,6075,2495759,2458951,1341669,3800620,1085231
2510848,2506212,4890,2511102,2475446,1346690,3822136,1096629
2559232,2553647,5841,2559488,2522184,1229653,3751837,1262344
2567168,2560296,6869,2567165,2528474,941175,3469649,1554120
2625792,2619849,6232,2626081,2587430,1083129,3670559,1453358
2623744,2616535,7233,2623768,2584037,1014684,3598721,1535570
2681600,2674454,7450,2681904,2641239,1156540,3797779,1455401
2722304,2716045,6289,2722334,2682586,1186318,3868904,1451162
2762240,2754468,8048,2762516,2720117,1274354,3994471,1384756
2775808,2768273,7815,2776088,2733832,1300830,4034662,1355479
2829056,2821403,7986,2829389,2786247,1341138,4127385,1404458
2848512,2840112,8695,2848807,2804756,1367035,4171791,1404332
2881280,2872000,9311,2881311,2836242,1440153,4276395,1361023
2912512,2904172,8631,2912803,2868032,1464861,4332893,1367838
2945024,2938050,7287,2945337,2901764,1463995,4365759,1391773
2957056,2948156,9214,2957370,2911475,1506390,4417865,1368590
2984192,2976860,7654,2984514,2939928,1539525,4479453,1362103
3070976,3062485,8815,3071300,3024459,1690648,4715107,1294001
3088384,3079159,9524,3088683,3040895,1759953,4800848,1239278
3112960,3104580,8708,3113288,3065893,1732542,4798435,1292659
3136000,3126984,9390,3136374,3087929,1776984,4864913,1269276
3198720,3189517,9519,3199036,3149865,2435750,5585615,659781
3217408,3207293,10442,3217735,3167231,2007505,5174736,1113778
3271680,3263459,8566,3272025,3223098,2003390,5226488,1173154
3280640,3269850,11113,3280963,3229068,1990021,5219089,1193289
3327744,3320561,7551,3328112,3279563,2093072,5372635,1138349
3371008,3362273,9080,3371353,3320539,2641437,5961976,620819
3387648,3381342,6661,3388003,3339577,2787414,6126991,490878
3455744,3446427,9422,3455849,3403705,2393057,5796762,956440
3452672,3440989,12006,3452995,3397599,2272165,5669764,1074031
3503616,3490931,13042,3503973,3447225,2732912,6180137,653586
3544064,3532695,11730,3544425,3488709,2981811,6470520,441367
3582464,3575459,7396,3582855,3531404,3009037,6540441,456685
3596544,3586110,10552,3596662,3541679,2565308,6106987,919889
3608576,3598655,10288,3608943,3553891,3108265,6662156,377574
3710208,3699443,11153,3710596,3653246,3259410,6912656,322416
3712768,3704658,8524,3713182,3658927,3289635,6948562,297634
3754240,3747392,7273,3754665,3701316,3359375,7060691,268541
3785472,3777907,7836,3785743,3731447,3421429,7152876,235596
3826944,3819657,7705,3827362,3772555,3462455,7235010,234625
3840512,3828334,12569,3840903,3780546,3071666,6852212,642384
3905024,3886526,18964,3905490,3836968,2888882,6725850,885866
3939840,3923880,16420,3940300,3874130,2926888,6801018,883814
3968000,3953717,14709,3968426,3903970,3007047,6911017,831063
3999488,3981059,18882,3999941,3930094,3030208,6960302,834316
4032768,4017463,15785,4033248,3967045,3587128,7554173,302157
4092672,4085043,8046,4093089,4034451,3847992,7882443,102833
4124416,4115989,8837,4124826,4065287,3904153,7969440,76221
4184576,4175503,9511,4185014,4123835,3985857,8109692,51270
4272128,4263617,8923,4272540,4211077,4074775,8285852,47693
4225280,4217448,8260,4225708,4165555,4032986,8198541,44935
4262400,4246708,16187,4262895,4193462,3788191,7981653,323025
4288768,4278003,11214,4289217,4225128,4088777,8313905,47673
4345600,4328346,17738,4346084,4273465,3756019,8029484,435775
4361984,4336262,26238,4362500,4280302,3556451,7836753,647062
4417024,4404251,13212,4417463,4349373,4213776,8563149,44098
4478976,4466354,13093,4479447,4411051,4270978,8682029,47454
4484608,4472279,12769,4485048,4416915,4277697,8694612,46284
4543488,4530359,13671,4544030,4473878,4263768,8737646,117564
4519936,4494767,25737,4520504,4436819,3729115,8165934,626900
4543232,4527125,16596,4543721,4470312,4188434,8658746,191106
4596992,4586728,10780,4597508,4529787,4392727,8922514,41719
4644608,4635114,9978,4645092,4577963,4439162,9017125,42685
4753152,4742357,11311,4753668,4683666,4543339,9227005,41611
4735488,4724111,11887,4735998,4665683,4524112,9189795,43386
4738048,4719572,19033,4738605,4660143,4408391,9068534,156594
4788736,4764999,24209,4789208,4704369,4532088,9236457,73854
4782848,4768913,14442,4783355,4709406,4564703,9274109,45703
4906752,4895775,11550,4907325,4835078,4691840,9526918,41249
4931584,4919983,12123,4932106,4859075,4714018,9573093,42647
4920576,4888470,32434,4920904,4825291,4566124,9391415,160607
4990720,4971331,19905,4991236,4909190,4759225,9668415,46722
4996608,4979958,17194,4997152,4917900,4770535,9688435,43964
4983552,4971931,12121,4984052,4910537,4765449,9675986,41687
5376256,5350141,26231,5376372,5281624,5097261,10378885,73900
5697536,5644820,53779,5698599,5568757,5354554,10923311,98680
5995264,5978098,17553,5995651,5903572,5736996,11640568,41862
6320640,6291902,29203,6321105,6212254,6039624,12251878,41690
6580224,6546487,34508,6580995,6462821,6288090,12750911,38540
6871808,6837520,35072,6872592,6750362,6567723,13318085,40634
7059456,7013466,46853,7060319,6921930,6739676,13661606,36679
7390464,7333930,57446,7391376,7237332,7048817,14286149,36489
7611392,7570265,41975,7612240,7473023,7280049,14753072,36358
7726080,7636814,84003,7720817,7534639,7336201,14870840,41104
7873536,7784816,89662,7874478,7679698,7480981,15160679,38841
8000000,7925133,75852,8000985,7819206,7622053,15441259,34293
7995392,7923977,72390,7996367,7818472,7623574,15442046,32323
8175872,7661069,511593,8172662,7484576,7130886,14615462,214052
8071424,7657693,414517,8072210,7498137,7155175,14653312,199431
8260864,8022932,223006,8245938,7892568,7649726,15542294,84757
8255488,7947626,294656,8242282,7805985,7528773,15334758,123589
8261376,8169141,91969,8261110,8058474,7855216,15913690,37480
