256,256,0,256,252,0,252,251
256,256,0,256,253,0,253,252
256,256,0,256,254,0,254,253
512,506,6,512,500,0,500,499
512,510,2,512,502,0,502,501
768,768,0,768,761,0,761,760
1024,1024,0,1024,1011,0,1011,1010
1024,1022,2,1024,1010,0,1010,1009
1536,1536,0,1536,1521,0,1521,1520
1792,1792,0,1792,1770,0,1770,1769
2560,2556,4,2560,2524,0,2524,2523
3328,3322,6,3328,3276,0,3276,3275
4352,4346,6,4352,4294,0,4294,4293
5632,5626,6,5632,5558,0,5558,5557
7424,7419,5,7424,7319,0,7319,7318
9728,9717,11,9728,9598,0,9598,9597
12544,12519,26,12545,12375,0,12375,12374
16640,16603,39,16642,16404,0,16404,16403
22016,21970,46,22016,21710,0,21710,21709
28672,28635,40,28675,28270,0,28270,28269
37888,37819,75,37894,37349,0,37349,37348
49664,49595,75,49670,48977,0,48977,48976
61952,61868,86,61954,61116,0,61116,61115
67584,67443,145,67588,66615,0,66615,66614
76032,75912,122,76034,74957,0,74957,74956
80128,79978,158,80136,79004,0,79004,79003
87552,87402,158,87560,86341,0,86341,86340
100096,99891,219,100110,98668,0,98668,98667
107264,107055,219,107274,105705,0,105705,105704
114944,114754,203,114957,113333,0,113333,113332
130304,130105,210,130315,128465,0,128465,128464
142336,142096,258,142354,140343,0,140343,140342
156672,156400,289,156689,154449,0,154449,154448
170752,170454,316,170770,168397,0,168397,168396
186880,186552,347,186899,184290,0,184290,184289
204288,203950,357,204307,201453,0,201453,201452
223232,222858,400,223258,220075,0,220075,220074
243712,243287,452,243739,240306,0,240306,240305
266496,266027,495,266522,262741,0,262741,262740
291072,290636,463,291099,287030,0,287030,287029
317184,316650,564,317214,312782,0,312782,312781
346112,345525,618,346143,341227,0,341227,341226
377600,377035,602,377637,372393,224,372617,372166
411648,410879,817,411696,405847,57,405904,405789
448512,447752,802,448554,442236,0,442236,442235
488704,487741,1022,488763,481707,73,481780,481633
531968,531066,956,532022,524513,228,524741,524283
579072,577897,1230,579127,570771,221,570992,570549
628480,627209,1329,628538,619513,631,620144,618881
682752,681517,1314,682831,673177,428,673605,672746
742144,740664,1566,742230,731526,655,732181,730869
805376,803953,1500,805453,793990,578,794568,793410
874752,872701,2128,874829,861899,2318,864217,859576
945408,943743,1745,945488,932006,573,932579,931432
1026816,1024791,2131,1026922,1012077,2922,1014999,1009147
1109504,1106751,2871,1109622,1092930,5196,1098126,1087728
1200128,1197930,2324,1200254,1183161,3255,1186416,1179897
1294336,1291624,2854,1294478,1275617,3105,1278722,1272505
1408000,1405079,3075,1408154,1387557,4266,1391823,1383283
1517568,1514234,3510,1517744,1495358,4738,1500096,1490613
1632000,1628528,3651,1632179,1608333,7258,1615591,1601061
1744896,1741023,4064,1745087,1719417,7823,1727240,1711573
1880064,1875602,4661,1880263,1852442,10771,1863213,1841654
2015744,2011600,4365,2015965,1986567,11886,1998453,1974662
2174976,2170063,5130,2175193,2143173,12010,2155183,2131150
2301696,2295830,6078,2301908,2267176,19911,2287087,2247249
2456576,2450817,6036,2456853,2420466,8579,2429045,2411880
2611200,2604555,6903,2611458,2572313,21411,2593724,2550885
2778880,2771783,7347,2779130,2737404,39303,2776707,2698068
2953728,2946168,7860,2954028,2909790,70637,2980427,2839132
3114240,3105937,8625,3114562,3067323,196452,3263775,2870807
3333888,3321009,13230,3334239,3279070,77495,3356565,3201518
3476224,3468393,8153,3476546,3425321,11942,3437263,3413369
3710464,3697200,13666,3710866,3651008,392905,4043913,3257764
3839232,3819728,19907,3839635,3770924,713736,4484660,3056859
4065024,4051379,14109,4065488,4000351,599216,4599567,3400705
4221952,4205327,17077,4222404,4151815,70078,4221893,4081694
4415488,4391887,24151,4416038,4335093,137079,4472172,4197964
4608000,4580410,28199,4608609,4520711,195963,4716674,4324668
4775168,4702657,71139,4773796,4636087,1256898,5892985,3378540
4990208,4877338,112890,4990228,4802303,942014,5744317,3859915
5160704,4983946,178047,5161993,4894955,831147,5726102,4063434
5327360,5090000,238178,5328178,4989750,1058303,6048053,3930992
5503744,5451690,43899,5495589,5380544,3257921,8638465,2120408
5656320,5395394,250445,5645839,5290538,2153345,7443883,3135879
5822720,5391366,430219,5821585,5256740,1234807,6491547,4021317
6015744,5879214,126496,6005710,5789279,3513222,9302501,2273836
6143488,5812166,332521,6144687,5687162,2177504,7864666,3508711
6314240,6127545,182400,6309945,6025983,3457522,9483505,2566141
6399488,6307731,79293,6387024,6221050,4227256,10448306,1991458
6548480,6325372,218633,6544005,6214110,3361480,9575590,2851389
6657024,6371298,262987,6634285,6253691,3243114,9496805,3008140
6772992,6360967,403337,6764304,6219265,2461205,8680470,3757174
6920192,6472583,431192,6903775,6325003,2454861,8779864,3868875
7015936,6497686,485814,6983500,6340588,2317880,8658468,4022038
7103488,6580702,485948,7066650,6421884,2491608,8913492,3929237
7166976,6772564,397431,7169995,6626089,3109993,9736082,3514418
7293440,6776490,511120,7287610,6610454,2604826,9215280,4004718
7295744,6851612,444384,7295996,6695764,2804696,9500460,3889865
7422208,7036477,388791,7425268,6887858,3427990,10315848,3458099
7550720,7069600,456578,7526178,6909406,2956350,9865756,3952004
7551744,7029701,471804,7501505,6867511,2866542,9734053,3999863
7699200,7267935,434589,7702524,7109321,3102351,10211672,4005296
7614208,7170646,434458,7605104,7013936,3198570,10212506,3813919
7830784,7302432,452389,7754821,7140023,3108578,10248601,4030304
7850496,7406366,446447,7852813,7245009,3260215,10505224,3983065
7966208,7518993,436030,7955023,7357922,3346851,10704773,4009831
7985664,7539222,422753,7961975,7379887,3395822,10775709,3982477
7963904,7525693,401227,7926920,7369160,3333877,10703037,4037993
8080640,7758739,280155,8038894,7621658,4785660,12407318,2829219
8142848,7826898,246145,8073043,7696672,5385785,13082457,2308463
8076544,7616223,418912,8035135,7457424,3525133,10982557,3930954
8083968,7637071,417517,8054588,7478546,3511831,10990377,3964963
8064512,7642229,416772,8059001,7483114,3510724,10993838,3970775
8367616,7993902,330730,8324632,7843335,3773564,11616899,4068177
8298496,7983564,258947,8242511,7845328,4901732,12747060,2940868
8303104,7840333,380429,8220762,7684748,3683585,11368333,3999857
8306432,7878473,384791,8263264,7723079,3794354,11517433,3927137
8297984,7873279,386572,8259851,7718023,3796068,11514091,3920385
8305408,7913381,354571,8267952,7760071,3757260,11517331,4000791
8276480,7804433,389052,8193485,7647542,3654202,11301744,3991744
8302848,7829269,367319,8196588,7676200,3696074,11372274,3978252
